
NO      textures/P_20210129_142919_005.xpm
  SO      textures/bookshelf-in-library-vector.xpm 

     F  110  ,  30      , 40
      EA textures/red.xpm  
WE textures/unnamed.xpm




    
C  190 ,  34 , 255

111111111111111111111111
1000000000110000000000001
101100000111000000000001
100100E0000000000000001
111111111011000001110000000000001
100000000011000001110111111111111
11110111111111011100000010001
11110111111111011101010010001                           
11000000110101011100000010001
10000000000000001100000010001
10000000000000001101010010000
1100000111010101111101111000111 11110111 1110101 101111010001
11111111 1111111 1111111111

