
C 50, 50, 50
SO textures/eagle.xpm 
EA textures/red.xpm  
WE textures/unnamed.xpm
NO textures/P_20210129_142919_005.xpm  
F 190,34,255

1111111111111111111111
1000000000110000000001
1011000001110E00000001
1001000000000000000001
1111111110110000011101
1000000000110000011101
1111011111111101110001
1111011111111101110101
1100000011010101110001
1000000000000000110001
1100000111010101111101
1000000000000000110101
1111111111111111111111 
